30
16
4 4 4 4 4 4 4 4 4 4 4 4 4 4 4 4 4 4 4 4 4 4 4 4 4 4 4 4 10 10 
4 4 4 4 4 4 4 4 4 4 9 9 4 4 4 4 4 4 4 4 4 4 4 4 4 4 4 4 10 10 
4 4 4 4 4 4 4 4 4 4 9 9 9 9 4 4 4 4 4 4 4 4 4 4 4 4 4 4 10 10 
4 4 4 4 4 4 4 4 4 4 9 9 9 9 4 4 4 4 4 4 4 4 4 4 4 4 4 4 10 10 
4 4 4 4 4 4 4 4 4 4 4 4 4 4 4 4 4 4 4 4 4 4 4 4 4 4 4 4 10 10 
4 4 4 4 4 4 4 4 4 4 4 4 4 4 4 4 4 4 4 4 4 4 4 4 4 4 4 4 10 10 
4 4 4 4 4 4 4 4 4 4 4 4 4 4 4 4 4 4 4 4 4 4 4 4 4 4 4 4 10 10 
0 0 0 0 0 0 0 0 0 0 0 0 0 0 0 0 0 0 0 0 0 0 0 0 0 0 6 0 10 10 
4 4 4 4 4 4 4 4 4 4 4 4 4 4 4 4 4 4 4 4 4 4 4 4 4 4 4 4 10 10 
4 4 4 4 4 4 4 4 4 4 4 4 4 4 4 4 4 4 4 4 4 4 9 4 4 4 4 4 10 10 
4 4 4 4 4 4 4 4 4 4 4 4 4 4 4 4 4 4 4 4 4 9 9 9 4 4 4 4 10 10 
4 4 4 4 4 4 4 9 9 4 4 4 4 9 9 9 4 4 4 4 4 9 9 9 4 4 4 4 10 10 
4 4 4 4 4 4 4 4 4 4 4 4 4 9 9 9 4 4 4 4 4 9 9 9 4 4 4 4 10 10 
4 4 4 4 4 4 4 4 4 4 4 4 4 4 9 9 4 4 4 4 4 4 4 4 4 4 4 4 10 10 
4 4 4 4 4 4 4 4 4 4 4 4 4 4 4 4 4 4 4 4 4 4 4 4 4 4 4 4 10 10 
4 4 4 4 4 4 4 4 4 4 4 4 4 4 4 4 4 4 4 4 4 4 4 4 4 4 4 4 10 10 
